105,106,107,108,109,110,111,112
97,147,148,149,150,151,153,154,155,156
97,98,99,101,102,103,104,105,156,157,158,159,160
103,104,105,106
147,148,149,150,153,154,155,156,157,158,159
148,149,150,151,152,153,154,155,156,157,158
112
97,98,99,100,102,107,108,111,112
112
