1,2,3,4,5,6,7,8,9,10,11,12,13,14,15,16,17,18,19,20,21,22,23,24,25,26,27,28,29,30,31,32,33,34,35,36,37,38,39,40,41,42,43,44,45,46,47,48,49,50,51,52,53,54,55,56,57,58,59,60,61,62,63,64,65,66,67,68,69,70,71,72,73,74,75,76,77,78,79,80,81,82,83,84,85,86,87,97,98,99,100,101,102,103,113,114,115,116,117,118,119,121,122,123,124,125,126,127,128,129,130,131,132,133,134,135,137,138,139,140,141,142,143,144,145,146,147,148,149,150,151,153,154,155,156,157,158,159,160,161,162,163,164,165,166,167,169,170,171,172,173,174,175,176
1,2,3,4,5,6,7,8,9,10,11,12,13,14,15,16,17,18,19,20,21,22,23,24,25,26,31,32,33,34,36,37,38,39,40,41,47,48,49,52,53,54,55,56,57,64,65,71,72,113,128,129,130,143,144,145,146,159,160,161,162,163,164,165,166,167,169,170,171,172,173,174,175,176
1,2,3,4,5,6,7,8,9,10,11,12,13,14,15,16,17,18,19,20,21,22,23,24,25,26,27,28,29,30,31,32,33,34,35,36,37,38,39,40,41,42,45,46,47,48,49,50,51,52,53,54,55,56,57,58,62,63,64,65,66,67,68,69,70,71,72,73,79,80,113,114,115,117,118,119,120,121,122,129,130,131,133,134,135,136,137,138,145,146,147,149,150,151,152,153,154,155,161,162,163,165,166,167,168,169,170,171,172,173,174,175,176
1,2,3,4,5,6,7,8,9,10,11,12,13,14,15,16,17,20,21,22,23,24,25,26,27,28,29,30,31,32,33,37,38,39,40,41,42,43,44,45,46,47,48,49,54,55,56,57,58,59,60,61,62,63,64,71,73,74,75,76,77,78,79,80,92,93,94,95,96,108,109,110,111,112,118,119,120,121,122,124,125,126,127,128,133,134,135,136,137,138,140,141,142,143,144,145,146,147,148,149,150,151,152,153,154,156,157,158,159,160,161,162,163,164,165,166,167,168,169,170,172,173,174,175,176
1,2,3,4,5,6,7,8,9,10,11,12,13,14,15,16,17,18,19,20,21,22,23,24,25,26,27,28,30,31,32,33,34,35,36,37,38,39,40,41,42,49,50,51,52,53,54,55,56,57,65,66,67,68,71,72,81,97,113,129,145,146,151,152,160,161,162,163,164,165,166,167,168,169,170,171,172,173,174,175,176
1,2,3,4,5,6,7,8,9,10,11,12,13,14,15,16,17,18,19,20,21,22,23,24,25,26,27,28,29,30,31,32,48,64,69,70,75,76,84,85,86,87,90,91,92,93,101,107,108,128,144,145,146,147,159,160,161,162,163,164,165,166,167,168,169,170,171,172,173,174,175,176
1,2,3,4,5,6,7,8,9,10,11,12,13,14,15,16,17,18,19,20,21,22,23,26,27,28,29,30,31,32,33,34,35,36,43,44,45,46,47,48,49,50,51,59,60,61,62,63,64,80,113,114,115,123,124,125,126,127,128,129,130,131,132,139,140,141,142,143,144,145,146,147,148,149,150,151,154,155,156,157,158,159,160,161,162,163,164,165,166,167,168,169,170,171,172,173,174,175,176
1,2,3,4,5,6,7,8,9,10,11,12,13,14,15,16,17,18,19,20,21,22,23,24,25,26,27,28,29,30,31,32,33,34,35,36,37,38,39,40,41,42,43,44,45,46,47,48,49,50,51,52,53,54,55,58,59,60,61,62,63,64,65,66,67,68,69,70,76,79,80,113,114,115,116,118,119,122,123,124,125,126,127,128,129,130,131,132,134,135,136,137,138,139,140,141,142,143,144,145,146,147,148,150,151,152,153,154,155,156,157,158,159,160,161,162,163,164,166,167,168,169,170,171,172,173,174,175,176
1,2,3,4,5,6,7,8,9,10,11,12,13,14,15,16,17,18,19,20,21,22,23,26,27,28,29,30,31,32,33,34,35,36,43,44,45,46,47,48,49,50,51,59,60,61,62,63,64,80,113,114,115,123,124,125,126,127,128,129,130,131,132,139,140,141,142,143,144,145,146,147,148,149,150,151,154,155,156,157,158,159,160,161,162,163,164,165,166,167,168,169,170,171,172,173,174,175,176
1,2,3,4,5,6,7,8,9,10,11,12,13,14,15,16,17,18,19,20,21,22,23,24,25,26,27,28,29,30,31,32,33,34,35,36,46,47,48,49,55,63,64,65,70,80,85,87,89,91,93,96,97,102,112,113,119,127,128,129,130,131,132,142,143,144,145,146,147,148,149,150,151,152,153,154,155,156,157,158,159,160,161,162,163,164,165,166,167,168,169,170,171,172,173,174,175,176
1,2,3,4,5,6,7,8,9,10,11,12,13,14,15,16,17,18,20,21,22,23,24,25,26,27,28,29,30,31,32,33,34,47,48,49,64,65,80,81,96,97,112,113,128,129,130,143,144,145,146,147,148,149,150,152,153,154,155,156,157,159,160,161,162,163,164,165,166,168,169,170,171,172,173,175,176
1,2,3,4,5,6,7,8,9,10,11,12,13,14,15,16,17,18,19,20,21,22,23,24,25,26,27,28,29,30,31,32,33,34,35,47,48,49,50,64,65,80,81,96,97,112,113,114,128,129,130,131,144,145,146,147,148,149,150,151,153,154,155,156,157,158,159,160,161,162,163,164,165,166,167,169,170,171,172,173,174,175,176
1,2,3,4,5,6,7,8,9,10,11,12,13,14,15,16,17,18,19,20,21,22,23,24,26,27,28,29,30,31,32,33,34,35,36,37,38,39,40,45,46,47,49,50,51,52,53,54,55,62,65,66,67,68,69,70,71,81,82,83,84,85,97,98,99,100,101,103,113,114,115,116,117,119,125,126,129,130,131,132,133,135,136,141,142,143,145,146,147,148,149,151,152,153,154,155,156,157,158,159,160,161,162,163,164,165,167,168,169,170,171,172,173,174,175,176
1,2,3,4,5,6,7,8,9,10,11,12,13,14,15,16,17,18,19,20,21,22,23,24,25,27,28,29,30,31,32,35,36,37,38,43,44,45,46,47,48,52,53,60,61,62,63,64,77,78,79,80,95,96,112,116,117,128,131,132,133,134,143,144,145,146,147,148,149,150,151,152,153,154,155,156,157,159,160,161,162,163,164,165,166,167,168,169,170,171,172,173,175,176
49,50,51,52,53,54,55,56,57,58,65,66,67,68,69,71,72,73,74,81,82,83,84,85,87,88,89,90,97,98,99,100,101,103,104,105,106,113,114,115,116,117,119,120,121,122,129,130,131,132,133,135,136,137,138,145,146,147,148,149,151,152,153,154,161,162,163,164,165,167,168,169,170
2,3,4,5,6,7,8,9,10,11,12,13,14,15,18,19,20,21,22,23,24,25,26,27,28,29,30,31,34,47,50,63,66,79,82,95,98,111,114,127,130,143,146,147,148,149,150,151,152,154,155,156,157,158,159,162,163,164,165,166,167,168,170,171,172,173,174,175
1,2,3,4,5,6,7,9,10,11,12,13,14,15,16,17,18,19,20,21,22,23,25,27,28,29,30,31,32,33,34,35,49,50,65,81,97,113,114,129,130,131,145,146,147,148,149,150,151,152,153,154,155,156,157,158,159,160,161,162,163,164,165,166,167,168,169,170,171,172,173,174,175,176
1,2,3,4,5,6,7,9,10,11,12,13,14,15,16,17,18,19,20,21,22,23,25,26,27,28,29,30,31,32,47,48,64,80,96,112,128,143,144,145,146,147,148,149,150,151,152,153,154,155,156,157,158,159,160,161,162,163,164,165,166,167,168,169,170,171,172,173,174,175,176
1,2,3,5,6,7,8,9,10,11,12,13,14,15,16,17,18,19,21,22,23,24,26,27,28,29,30,31,32,33,34,35,37,38,39,40,49,50,51,53,54,55,65,66,67,69,70,81,82,97,113,129,130,145,146,147,148,149,150,151,152,153,154,155,156,157,158,159,160,161,162,163,164,165,166,167,168,169,170,171,172,173,174,175,176
1,2,3,4,5,6,7,8,9,10,12,13,14,15,16,17,18,20,21,22,23,24,25,26,28,29,30,31,32,36,37,38,39,40,41,42,44,45,46,47,53,54,55,56,57,58,60,61,62,70,71,72,73,74,76,77,145,146,147,148,149,150,151,152,153,154,155,156,157,158,159,160,161,162,163,164,165,166,167,168,169,170,171,172,173,174,175,176
1,2,3,4,5,6,7,8,9,10,11,12,13,14,15,16,17,18,19,20,21,22,23,24,25,26,27,28,29,30,31,32,47,48,64,80,145,146,147,148,149,150,151,152,153,154,156,157,158,159,160,161,162,163,164,165,166,167,168,169,170,172,173,174,175,176
1,2,3,4,5,6,7,8,9,10,11,12,13,14,15,16,17,18,19,20,21,22,23,24,25,26,27,28,29,30,31,32,33,34,35,36,37,38,39,40,43,44,47,48,49,50,51,52,53,54,55,56,65,66,67,68,69,70,71,72,82,83,86,87,130,131,134,135,139,140,143,144,145,146,147,149,150,151,152,153,154,155,156,157,159,160,161,162,163,165,166,167,168,169,170,171,172,173,175,176
1,2,3,4,5,6,7,8,9,10,11,12,13,14,15,16,17,18,19,20,21,22,24,25,26,27,28,29,30,31,32,33,34,37,38,41,42,43,44,45,46,47,57,58,59,60,61,62,73,74,75,76,77,108,109,124,125,126,129,130,133,134,140,141,142,143,145,146,147,148,149,150,151,152,153,154,155,156,157,158,159,160,161,162,163,164,165,166,167,168,169,170,171,172,173,174,175,176
1,2,3,4,6,7,8,9,10,11,12,13,14,15,16,17,18,19,20,22,23,24,25,26,27,28,29,30,31,32,35,36,38,39,40,41,42,43,44,45,46,47,48,52,54,55,56,57,58,59,60,61,62,63,64,68,70,145,146,147,148,149,150,156,157,158,159,160,161,162,163,164,165,166,172,173,174,175,176
1,2,3,4,5,6,7,8,9,10,11,12,13,14,15,16,17,18,19,20,21,22,23,24,25,26,27,28,29,30,31,32,33,34,35,36,37,38,39,40,41,42,43,44,45,46,47,48,49,50,51,52,53,54,55,56,57,58,59,60,61,62,63,64,121,122,123,124,125,126,127,128,137,138,139,140,141,142,143,144,145,146,147,148,149,150,151,152,153,154,155,156,157,158,159,160,161,162,163,164,165,166,167,168,169,170,171,172,173,174,175,176
1,2,3,4,5,6,7,8,9,10,11,12,13,14,15,16,17,18,19,20,21,22,23,24,25,26,27,28,29,30,31,32,33,34,35,36,37,38,39,40,41,42,43,44,45,46,47,48,49,50,51,52,53,54,55,56,57,58,59,60,61,62,63,64,113,114,115,116,117,118,119,120,121,122,123,124,125,126,127,128,129,130,131,132,133,134,135,136,137,138,139,140,141,142,143,144,145,146,147,148,149,150,151,152,153,154,155,156,157,158,159,160,161,162,163,164,165,166,167,168,169,170,171,172,173,174,175,176
1,2,3,4,5,6,8,9,10,11,12,13,15,16,17,18,19,20,21,22,24,25,26,27,28,29,31,32,33,34,35,36,37,38,40,41,42,43,44,45,47,48,49,50,51,52,53,54,56,57,58,59,60,61,63,64,72,73,74,75,76,77,79,80,112,113,114,115,116,117,118,119,128,129,130,131,132,133,134,135,144,145,146,147,148,149,150,151,152,153,154,155,156,157,158,159,160,161,162,163,164,165,166,167,168,169,170,171,172,173,174,175,176
1,2,3,4,5,6,7,9,10,11,12,13,14,15,16,17,18,19,20,21,22,23,25,26,27,28,29,30,31,32,33,34,35,46,47,48,49,50,54,63,64,65,66,68,73,75,79,80,86,93,97,98,100,105,107,111,112,113,114,118,127,128,129,130,131,142,143,144,145,146,147,148,149,150,151,153,154,155,156,157,158,159,160,161,162,163,164,165,166,167,169,170,171,172,173,174,175,176
1,2,3,4,5,7,8,9,10,11,12,13,14,15,16,17,18,19,20,21,23,24,25,26,27,28,29,30,31,32,33,34,49,65,72,74,78,97,104,106,108,110,113,129,130,145,146,147,149,150,151,152,153,154,155,156,157,158,159,160,161,162,163,165,166,167,168,169,170,171,172,173,174,175,176
1,2,3,4,5,6,7,8,9,10,11,12,13,15,16,17,18,19,20,21,22,23,24,25,26,27,28,29,31,32,37,38,39,40,41,42,43,44,45,47,48,55,56,57,58,59,60,61,63,64,70,71,72,73,74,86,87,102,118,133,134,135,145,146,148,149,150,151,161,162,164,165,166,167
1,2,3,4,5,7,8,9,10,11,12,13,14,15,16,17,18,19,20,21,23,24,25,26,27,28,30,31,32,33,34,35,36,37,39,40,41,42,49,50,51,52,53,55,56,57,72,73,104,105,120,121,136,137,152,153,154,155,156,157,158,159,160,168,169,170,171,172,173,174,175,176
1,2,3,4,5,6,7,8,9,10,11,12,13,14,15,17,18,19,20,21,22,23,24,25,26,27,28,29,30,31,47,63,79,95,111,127,143,145,146,147,148,149,150,151,152,153,154,155,156,157,158,159,161,162,163,164,165,166,167,168,169,170,171,172,173,174,175
1,2,3,4,5,6,7,8,9,10,11,12,13,14,15,16,17,18,19,20,21,22,23,24,25,26,27,28,29,30,31,32,33,34,35,49,50,65,66,81,82,97,98,113,114,129,130,145,146,159,160,161,162,175,176
1,2,3,4,5,6,7,8,9,10,11,12,13,14,15,16,17,18,19,20,21,22,23,24,25,26,27,28,29,30,31,32,47,48,63,64,79,80,95,96,111,112,127,128,143,144,145,146,159,160,161,162,175,176
1,2,3,4,5,6,7,8,9,10,11,12,13,14,15,16,17,18,19,20,21,22,23,24,25,26,27,28,29,30,31,32,33,34,47,48,49,50,63,64,65,66,79,80,81,82,95,96,97,98,111,112,113,114,127,128,129,130,143,144,145,146,147,148,149,150,151,153,154,155,156,157,158,159,160,161,162,163,164,165,166,167,169,170,171,172,173,174,175,176
1,2,3,4,5,6,7,8,9,10,11,12,13,14,15,16,17,18,19,20,21,22,23,24,25,26,27,28,29,30,31,32,33,34,40,41,42,43,49,57,58,65,69,73,74,81,86,89,90,97,101,105,106,113,121,122,129,130,136,137,138,139,145,146,147,148,149,150,152,153,154,155,156,157,159,160,161,162,163,164,165,166,168,169,170,171,172,173,175,176
1,2,3,4,5,6,7,8,9,10,12,13,14,15,16,17,18,19,20,21,22,23,24,25,26,28,29,30,31,32,36,37,67,70,73,76,99,102,105,108,111,132,133,145,146,147,148,149,150,151,152,153,154,155,156,157,158,159,160,161,162,163,164,165,166,167,168,169,170,171,172,173,174,175,176
1,2,3,5,6,7,8,9,10,11,12,13,15,16,17,18,19,21,22,23,24,25,26,28,29,31,32,47,48,64,67,70,73,76,80,96,99,102,105,108,112,128,143,144,145,146,147,148,150,151,152,153,154,155,156,157,158,159,160,161,162,163,164,166,167,168,169,170,171,172,173,174,175,176
1,2,3,4,5,6,7,8,9,10,11,12,13,14,15,16,17,18,19,21,22,23,24,25,26,27,28,29,30,31,32,33,34,39,40,41,43,44,45,46,47,48,49,55,56,59,60,61,62,63,64,65,81,97,113,119,120,129,130,134,135,136,137,145,146,149,150,151,152,153,161,162,165,166,167,168,169
1,2,3,4,5,6,12,13,14,15,16,17,18,19,20,21,22,28,29,30,32,33,34,35,36,37,38,44,45,46,49,50,51,52,53,54,60,61,62

1,2,3,4,5,6,7,8,9,10,11,12,13,14,15,16,17,18,19,20,21,22,23,24,25,26,27,28,29,30,31,32,145,146,147,148,149,150,151,152,153,154,155,156,157,158,159,160,161,162,163,164,165,166,167,168,169,170,171,172,173,174,175,176
1,2,3,4,5,6,7,8,9,10,11,12,13,14,15,16,17,18,19,20,21,22,23,24,25,26,27,28,29,30,31,32,145,146,160,161,162,176
1,2,3,4,5,6,7,8,9,10,11,12,13,14,15,16,17,18,19,20,21,22,23,24,25,26,27,28,29,30,31,32,145,159,160,161,175,176
1,2,3,5,6,7,8,9,10,11,12,13,14,15,16,17,18,19,21,22,23,24,25,26,27,28,29,30,31,32,45,46,47,48,55,56,57,58,61,62,63,64,70,71,72,73,74,75,77,78,79,80,86,87,88,89,90,91,103,104,105,107,145,146,147,148,149,150,151,152,153,154,155,156,157,158,159,160,161,162,163,164,165,166,167,168,169,170,171,172,173,174,175,176
1,2,4,5,6,7,17,18,20,21,23,33,34,36,49,50,52,65,66,68,146,147,148,149,150,151,154,155,156,157,158,159,160,161,162,163,164,165,166,167,170,171,172,173,174,175,176
145,146,161,162
1,2,3,4,5,6,7,8,9,10,11,12,13,14,15,16,17,18,19,20,21,22,23,24,25,26,27,28,29,30,31,32,33,46,47,48,49,62,63,64,65,78,79,80,81,94,95,96,97,110,111,112,113,126,127,128,129,142,143,144,145,146,147,148,149,150,152,153,154,155,156,157,158,159,160,161,162,163,164,165,166,168,169,170,171,172,173,174,175,176
1,2,15,16,17,18,31,32,33,34,49,50,65,66,81,82,97,98,113,114,129,130,145,146,159,160,161,162,175,176
1,2,15,16,17,18,31,32,47,48,63,64,127,128,143,144,145,146,159,160,161,162,175,176
1,2,3,4,5,6,7,9,10,11,12,13,14,15,16,17,18,19,20,21,22,23,25,26,27,28,29,30,31,32,33,34,35,36,37,38,39,41,44,45,46,47,48,49,50,53,54,55,57,62,63,64,70,71,73,78,79,80,110,111,112,113,114,126,127,128,129,130,131,142,143,144,145,146,147,148,149,150,151,152,153,154,155,156,157,158,159,160,161,162,163,164,165,166,167,168,169,170,171,172,173,174,175,176
1,2,3,4,5,6,8,9,10,11,12,13,15,16,17,18,19,20,21,22,24,25,26,28,29,31,32,33,34,47,48,49,50,63,64,65,66,79,80,95,96,97,98,111,112,113,114,127,128,129,130,143,144,145,146,147,148,149,150,151,152,153,154,155,156,157,158,159,160,161,162,163,164,165,166,167,168,169,170,171,172,173,174,175,176
1,2,3,4,5,6,7,8,9,10,11,12,13,14,15,16,17,18,19,20,21,22,23,24,25,26,27,28,29,30,31,32,33,34,47,48,49,63,64,65,80,81,96,97,113,129,130,145,146,147,148,149,150,151,152,161,162,163,164,165,166,167,168
1,2,3,4,6,7,8,9,10,11,12,13,14,15,16,17,18,19,20,22,23,24,25,26,27,28,29,30,31,32,33,34,35,36,38,39,40,41,42,43,44,45,46,47,48,49,50,51,52,54,55,56,57,58,59,60,61,62,63,64,65,66,67,68,81,82,83,84
1,2,5,6,7,8,9,17,18,21,22,23,24,25,33,34,37,38,39,40,41,49,50,53,54,55,56,57
2,3,4,5,6,7,8,9,10,11,12,13,14,15,18,19,20,21,22,23,24,25,26,27,28,29,30,31,34,47,50,63,66,79,82,98,111,114,127,130,143,146,147,148,149,150,151,152,153,154,155,156,157,158,159,162,163,164,165,166,167,168,169,170,171,172,173,174,175

1,2,3,4,5,6,7,8,9,10,11,12,13,14,15,16,17,18,19,20,21,22,23,24,25,26,27,28,29,30,31,32,33,34,47,48,49,64,65,80,81,96,97,112,113,128,129,130,143,144,145,146,147,148,149,150,151,154,155,156,157,158,159,160,161,162,163,164,165,166,167,170,171,172,173,174,175,176
1,2,16,17,18,32,33,34,49,50,65,66,81,82,97,98,113,114,129,130,145,146,147,148,149,150,151,154,155,156,157,158,159,160,161,162,163,164,165,166,167,170,171,172,173,174,175,176
1,15,16,17,31,32,47,48,63,64,79,80,95,96,111,112,127,128,143,144,145,146,147,148,149,150,151,152,153,154,155,156,159,160,161,162,163,164,165,166,167,168,169,170,171,172,175,176


1,2,17,18,33,34,49,50,65,66,81,82,97,98,113,114,129,130,131,145,146,147,148,149,150,151,152,153,154,155,156,157,158,159,160,161,162,163,164,165,166,167,168,169,170,171,172,173,174,175,176
145,146,147,148,149,161,162,163,164,165
1,2,15,16,17,18,31,32,33,34,49,50,65,66,81,82,97,98,113,114,129,130,145,146,147,148,149,150,151,152,153,154,155,156,157,158,160,161,162,163,164,165,166,167,168,169,170,171,172,173,174,176
1,2,15,16,17,18,31,32,47,48,63,64,79,80,95,96,111,112,127,128,143,144,145,146,147,148,149,150,151,152,153,154,155,156,157,158,159,160,161,162,163,164,165,166,167,168,169,170,171,172,173,174,175,176
1,2,3,4,5,6,7,8,9,10,11,12,13,14,15,16,17,18,19,20,21,22,23,24,25,26,27,28,29,30,31,32,33,34,47,48,49,64,65,80,81,96,97,112,113,128,129,130,143,144,145,146,147,148,149,150,151,154,155,156,157,158,159,160,161,162,163,164,165,166,167,170,171,172,173,174,175,176
1,2,3,4,5,6,7,8,9,10,11,12,13,14,15,16,17,18,19,20,21,22,23,24,25,26,27,28,29,30,31,32,33,34,47,48,49,64,65,80,81,96,97,112,113,128,129,130,143,144,145,146,147,148,149,150,151,154,155,156,157,158,159,160,161,162,163,164,165,166,167,170,171,172,173,174,175,176
1,2,3,4,5,6,7,8,17,18,19,20,22,23,24,33,34,49,65,81,97,113,129,130,145,146,147,148,149,150,151,161,162,163,164,165,166,167
2,3,4,5,6,7,8,9,10,11,12,13,14,15,18,19,20,21,22,23,24,25,26,27,28,29,30,31,34,47,50,63,66,79,82,95,98,111,114,127,130,143,146,147,148,149,150,151,152,154,155,156,157,158,159,162,163,164,165,166,167,168,170,171,172,173,174,175









1,2,3,4,5,17,18,19,20,21,33,34,35,36,49,50,51,52,65,66,67,68,81,82,83,97,98,113,114,129,130,131,145,146,147,148,149,161,162,163,164,165
1,2,3,4,5,6,7,8,9,10,11,12,13,14,16,17,18,19,20,21,22,23,24,25,26,27,28,29,30,32,33,34,35,36,37,38,39,40,41,42,43,44,45,46,48,49,50,51,52,53,54,55,56,57,58,59,60,61,62,64,65,66,67,68,69,70,71,72,73,74,75,76,77,78,80,81,82,96,97,98,112,113,114,128,129,130,144,145,146,159,160,161,162,175,176














1,2,3,4,5,17,18,19,20,21,33,34,35,36,49,50,51,52,65,66,67,68,81,82,83,97,98,113,114,129,130,131,145,146,147,148,149,161,162,163,164,165















1,2,3,4,5,17,18,19,21,145,146,147,148,149,161,162,163,164,165
1,2,3,4,5,6,7,8,9,10,11,12,13,14,15,16,17,18,19,20,21,22,23,24,25,26,27,29,30,31,32,33,34,35,36,49,50,51,65,66,81,97,98,113,114,115,129,130,131,132,145,146,147,148,149,150,151,152,153,154,155,156,157,158,159,160,161,162,163,164,165,166,167,168,169,170,171,172,173,174,175,176
1,2,3,4,5,6,7,8,9,10,13,14,15,16,17,18,19,20,21,23,24,25,26,29,30,31,32,46,47,48,63,64,127,128,142,143,144,145,146,147,148,149,150,151,152,153,154,155,156,157,158,159,160,161,162,163,164,165,166,167,168,169,170,171,172,173,174,175,176







1,2,3,4,5,6,7,8,9,10,11,12,13,14,15,16,17,18,19,20,21,22,23,24,25,26,27,28,29,30,31,32,34,35,36,37,38,45,46,47,48,51,52,53,54,62,63,64,68,69,70,74,78,79,80,85,86,89,91,106,110,111,112,126,127,128,133,134,141,142,143,144,145,146,147,148,149,150,151,152,153,154,155,156,157,158,159,160,161,162,163,164,165,166,167,168,169,170,171,172,173,174,175,176
1,2,3,4,5,6,7,8,9,10,11,12,13,14,15,16,17,18,19,20,21,22,23,24,25,26,27,28,29,30,31,32,33,34,35,36,37,38,39,42,43,44,45,46,47,48,49,50,51,52,59,60,61,62,63,64,65,66,67,75,76,77,78,79,80,97,98,99,107,108,109,110,111,112,113,114,115,116,123,124,125,126,127,128,129,130,131,132,133,134,135,138,139,140,141,142,143,144,145,146,147,148,149,150,151,152,153,154,155,156,157,158,159,160,161,162,163,164,165,166,167,168,169,170,171,172,173,174,175,176
1,2,3,4,5,6,7,8,9,10,11,15,16,17,18,19,20,21,22,23,24,25,27,31,32,33,34,35,36,37,38,39,49,50,51,52,53,54,65,66,67,68,69,97,98,99,100,101,113,114,115,116,117,118,129,130,131,132,133,134,135,145,146,147,148,149,150,151,161,162,163,164,165,166,167
1,2,3,4,5,6,7,8,9,10,11,12,13,14,15,16,17,18,19,20,21,22,24,25,26,27,28,29,30,31,32
1,2,3,4,5,6,7,8,9,10,11,12,13,14,15,16,17,18,19,20,21,22,24,25,26,27,28,29,30,31,32
1,2,3,4,5,6,7,8,9,10,11,12,13,14,15,16,17,18,19,20,21,22,23,24,25,26,27,28,29,30,31,32,35,36,37,38,39,40,41,42,43,44,45,46,47,48,51,52,53,54,55,56,57,58,59,60,61,62,63,64
1,2,3,4,5,17,18,19,20,21,33,34,35,36,37,49,50,51,52,53
