







































1,2,3,4,5,6,7,8,9,10,11,12,13,14,15,16,17,18,19,20,21,22,23,24,25,26,27,28,29,30,31,32,47,143,154,155,156,157,158,159,160,170,171,172,173,174,175,176















10,11,12,13,14,15,16,26,27,28,29,30,31,32,43,48,64,77,80,96,109,112,128,139,144,154,155,156,157,158,159,160,170,171,172,173,174,175,176









68,77,100,109














1,2,3,4,5,6,7,8,9,10,11,12,13,14,15,16,17,18,19,20,21,22,23,24,25,26,27,28,29,30,31,32,33,34,45,46,47,48,49,61,62,63,64,65,68,70,72,74,81,97,100,102,104,113,125,126,127,128,129,130,141,142,143,144,145,146,147,148,149,150,151,152,153,154,157,158,159,160,161,162,163,164,165,166,167,168,169,170,173,174,175,176
1,2,3,4,5,6,7,10,11,12,13,14,15,16,17,18,19,20,21,22,23,26,27,28,29,30,31,32,33,34,49,50,53,54,55,56,57,58,59,60,61,62,63,64,69,70,71,72,73,74,75,76,77,78,79,80,85,86,87,88,89,90,91,92,93,94,95,96,101,102,103,104,105,106,107,108,109,110,111,112,113,114,117,118,119,120,121,122,123,124,125,126,127,128,129,130,145,146,147,148,149,152,153,159,160,161,162,163,164,165,168,169,175,176
1,2,3,4,5,6,7,10,11,12,13,14,15,16,17,18,19,20,21,22,23,26,27,28,29,30,31,32,47,48,49,50,64,65,66,81,82,97,98,113,114,128,143,144,145,146,147,148,151,155,157,159,160,161,162,163,164,167,171,173,175,176












1,2,15,16,17,18,31,32,33,34,47,48,49,50,64,65,66,81,82,97,98,113,114,128,129,130,143,144,145,146,147,148,149,150,151,152,153,154,155,156,157,158,159,160,161,162,163,164,165,166,167,168,169,170,171,172,173,174,175,176
1,2,3,4,5,6,7,8,9,10,13,14,15,16,17,18,19,20,21,22,23,24,25,26,29,30,31,32,33,34,35,36,37,38,39,40,41,42,45,46,47,48,49,50,51,52,53,54,55,56,57,58,61,62,63,64,113,114,115,116,117,118,119,120,121,122,125,126,127,128,129,130,131,132,133,134,135,136,137,138,141,142,143,144,145,146,147,148,149,150,151,152,153,154,157,158,159,160,161,162,163,164,165,166,167,168,169,170,173,174,175,176
1,2,3,4,5,8,9,15,16,17,18,19,20,21,24,25,31,32,33,34,35,36,37,47,48,49,50,51,52,53,57,73,89,105,113,114,115,116,117,118,121,122,123,124,125,126,129,130,131,132,133,134,137,138,139,140,141,142,143,144,145,146,147,148,149,150,153,154,155,156,157,158,159,160,161,162,163,164,165,166,169,170,171,172,173,174,175,176
1,2,3,4,7,11,13,15,16,17,18,19,20,23,27,29,31,32,33,34,47,48,52,59,64,71,84,91,93,116,123,128,129,130,143,144,145,146,147,148,149,150,151,155,157,159,160,161,162,163,164,165,166,167,171,173,175,176














1,2,3,4,5,6,9,10,11,12,13,14,15,16,17,18,19,20,21,22,25,26,27,28,29,30,31,32,33,34,35,36,37,38,49,50,51,52,53,54,55,56,57,58,59,60,61,62,63,64,67,68,69,70,71,72,73,74,75,76,77,78,79,80,87,88,89,90,91,92,93,94,95,96,103,104,105,106,107,108,109,110,111,112,113,114,119,120,121,122,123,124,125,126,127,128,129,130,145,146,147,148,149,150,151,152,153,154,155,156,157,158,159,160,161,162,163,164,165,166,167,168,169,170,171,172,173,174,175,176
1,2,3,4,5,6,7,11,13,15,16,17,18,19,20,21,22,23,27,29,31,32,47,48,49,50,51,52,53,54,55,64,65,66,67,68,69,70,71,81,82,83,84,85,86,87,91,97,98,99,100,101,102,103,113,114,115,116,117,118,119,128,143,144,145,146,147,148,149,150,151,152,153,154,155,156,157,158,159,160,161,162,163,164,165,166,167,168,169,170,171,172,173,174,175,176











