







































60,78,92,124
















68,77,100,109



1,2,3,4,5,6,7,10,11,12,13,14,15,16,17,18,19,20,21,22,23,26,27,28,29,30,31,32,33,38,48,49,51,53,60,64,65,71,78,80,81,83,85,92,96,97,110,112,113,115,117,124,128,129,144,145,147,149,151,154,156,158,160,161,163,165,167,170,172,174,176





68,77,100,109
68,70,100,102

123,124,125,126,127,128,138,139,140,141,142,143,144,154,155,156,157,158,159,160,170,171,172,173,174,175,176
113,114,115,116,117,118,119,120,121,122,123,125,126,127,128,129,130,131,132,133,134,135,136,137,138,139,140,141,142,143,144,145,146,147,148,149,150,151,152,153,154,155,156,157,158,159,160,161,162,163,164,165,166,167,168,169,170,171,172,173,174,175,176
10,11,12,13,14,15,16,26,27,28,29,30,31,32,46,47,48,62,63,64,78,79,80,94,95,96,110,111,112,113,114,115,126,127,128,129,130,131,142,143,144,145,146,147,148,149,150,151,154,155,156,157,158,159,160,161,162,163,164,165,166,167,170,171,172,173,174,175,176
1,2,3,4,5,6,7,10,11,12,13,14,15,16,17,18,19,20,21,22,23,26,27,28,29,30,31,32,33,34,38,39,42,43,44,45,46,47,48,49,50,55,58,59,60,61,62,63,64,65,66,81,82,84,97,98,113,114,118,119,122,123,124,125,126,127,128,129,130,134,135,138,139,140,141,142,143,144,145,146,147,148,149,150,151,154,155,156,157,158,159,160,161,162,163,164,165,166,167,170,171,172,173,174,175,176

1,2,3,4,5,6,7,8,9,10,11,12,15,16,17,18,19,20,21,22,23,24,25,26,27,28,31,32,33,43,44,47,48,49,55,59,60,63,64,73,75,76,79,80,83,87,91,92,95,96,105,107,108,111,112,113,119,123,124,127,128,129,139,140,143,144,145,147,151,153,155,156,159,160,161,163,167,169,171,172,175,176

1,3,5,7,10,12,14,16,17,19,21,23,26,28,30,32,33,48,49,55,60,64,67,69,74,78,87,92,99,101,106,110,113,119,124,128,129,144,145,146,147,149,150,151,152,153,154,155,156,158,159,160,161,162,163,165,166,167,168,169,170,171,172,174,175,176
1,2,3,4,5,6,7,8,9,10,11,12,13,14,15,16,17,18,19,20,21,22,23,24,25,26,27,28,29,30,31,32,33,34,47,48,49,64,80,96,112,113,128,129,130,143,144,145,146,147,148,149,150,151,152,153,154,155,156,157,158,159,160,161,162,163,164,165,166,167,168,169,170,171,172,173,174,175,176




71,91,103
1,2,3,4,5,6,7,17,18,19,20,21,22,23,33,34,49,50,54,86,113,114,118,129,130,145,146,147,150,151,152,153,156,157,161,162,163,166,167,168,169,172,173

10,11,12,13,14,15,16,26,27,28,29,30,31,32,75,77,78,107,109,110,148,149,150,151,152,153,154,155,156,157,158,159,160,164,165,166,167,168,169,170,171,172,173,174,175,176
1,2,3,4,5,6,7,8,9,10,11,12,13,14,15,16,17,18,19,20,21,22,23,24,25,26,27,28,29,30,31,32,56,58,62,64,84,86,88,90,92,94,96,120,122,126,128,145,146,147,148,149,150,151,152,153,154,155,156,157,158,159,160,161,162,163,164,165,166,167,168,169,170,171,172,173,174,175,176
1,2,3,4,5,6,7,10,11,12,13,14,15,16,17,18,19,20,21,22,23,26,27,28,29,30,31,32,48,49,51,55,58,60,64,81,83,85,87,90,92,94,113,115,119,122,124,128,144,145,146,147,149,151,154,156,158,160,161,162,163,165,167,170,172,174,176
1,2,3,4,5,6,7,10,11,12,13,14,15,16,17,18,19,20,21,22,23,26,27,28,29,30,31,32,33,34,35,36,37,38,39,42,43,44,45,46,47,48,49,50,51,52,53,54,55,58,59,60,61,62,63,64,113,114,115,116,117,118,119,129,130,131,132,133,134,135,145,146,147,148,149,150,151,161,162,163,164,165,166,167
1,2,3,4,5,6,7,8,9,10,11,12,13,14,15,16,17,18,19,20,21,22,23,24,25,26,27,28,29,30,31,32,33,34,35,49,50,51,156,157,158,160,172,173,174,176
1,3,7,9,11,12,15,16,17,19,23,25,27,28,31,32,59,64,67,71,73,80,91,96,99,103,105,112,123,128,145,147,151,153,155,156,158,159,160,161,163,167,169,171,172,174,175,176
1,2,3,4,5,6,7,8,9,10,11,12,13,14,15,16,17,18,19,20,21,22,23,24,25,26,27,28,29,30,31,32,46,47,48,49,50,51,52,53,54,55,56,57,58,59,60,62,63,64,65,66,67,68,69,70,71,72,73,74,75,76,81,82,83,84,85,86,87,88,89,90,91,92,97,98,99,100,101,102,103,104,105,106,107,108,113,114,115,116,117,118,119,120,121,122,123,124,126,127,128,134,135,136,137,138,139,140,142,143,144,145,146,147,148,150,151,152,153,154,155,156,158,159,160,161,162,163,164,166,167,168,169,170,171,172,174,175,176
1,2,3,5,6,7,8,9,10,11,12,14,15,16,17,18,19,21,22,23,24,25,26,27,28,30,31,32,33,34,35,37,38,39,40,41,42,43,44,46,47,48,49,50,51,53,54,55,56,57,58,59,60,62,63,64,113,114,115,117,118,119,120,121,122,123,124,126,127,128,129,130,131,133,134,135,136,137,138,139,140,142,143,144,145,146,147,149,150,151,152,153,154,155,156,158,159,160,161,162,163,165,166,167,168,169,170,171,172,174,175,176






71,103



3,5,7,10,12,14,16,19,21,23,26,28,30,32,48,53,58,62,64,67,85,87,90,92,94,99,117,122,126,128,144,147,149,151,154,156,158,160,163,165,167,170,172,174,176
1,2,3,4,5,6,7,17,18,19,20,21,22,23,33,34,49,54,67,86,99,113,118,129,130,145,146,147,148,149,150,151,152,153,154,155,156,157,158,159,160,161,162,163,164,165,166,167,168,169,170,171,172,173,174,175,176
12,13,14,16,28,29,30,32,77,145,146,147,148,149,150,151,152,153,154,155,156,157,158,159,160,161,162,163,164,165,166,167,168,169,170,171,172,173,174,175,176
1,3,7,9,11,12,14,15,16,17,19,23,25,27,28,30,31,32,47,48,59,64,67,71,73,91,99,103,123,128,143,144,145,146,147,148,149,150,151,152,153,154,155,159,160,161,162,163,164,165,166,167,168,169,170,171,175,176
1,2,3,4,6,7,8,9,10,11,12,14,15,16,17,18,19,20,22,23,24,25,26,27,28,30,31,32,33,34,35,36,38,39,49,50,51,52,54,62,63,64,70,78,79,80,86,94,95,96,102,110,111,112,113,114,115,116,117,118,126,127,128,129,130,131,132,133,134,135,145,146,147,148,149,150,151,152,153,154,155,156,157,158,159,160,161,162,163,164,165,166,167,168,169,170,171,172,173,174,175,176
1,2,3,5,6,7,8,9,10,11,12,14,15,16,17,18,19,21,22,23,24,25,26,27,28,30,31,32,46,47,48,49,50,53,54,55,56,57,58,59,60,62,63,64,65,66,69,70,71,72,73,74,75,76,81,82,85,86,87,88,89,90,91,92,97,98,101,102,103,104,105,106,107,108,113,114,117,118,119,120,121,122,123,124,125,126,127,128,133,134,135,136,137,138,139,140,141,142,143,144,145,146,147,148,149,150,151,152,153,154,155,156,157,158,159,160,161,162,163,164,165,166,167,168,169,170,171,172,173,174,175,176
1,2,3,4,5,6,7,8,9,10,11,12,13,14,15,16,17,18,19,20,21,22,23,24,25,26,27,28,29,30,31,32,33,34,49,52,53,54,75,76,77,78,84,85,86,107,108,109,110,113,116,117,118,129,130,145,146,147,148,149,150,151,152,153,154,155,156,157,158,159,160,161,162,163,164,165,166,167,168,169,170,171,172,173,174,175,176









3,5,7,10,12,14,16,19,21,23,26,28,30,32,55,58,60,62,67,69,87,90,92,94,99,119,122,124,126,147,148,149,150,151,152,153,154,155,156,157,158,159,160,163,164,165,166,167,168,169,170,171,172,173,174,175,176







