



























































1,2,3,4,5,6,7,8,9,10,11,12,13,14,15,16,17,18,19,20,21,22,23,24,25,26,27,28,29,30,31,32,33,34,35,47,48,49,50,64,65,80,81,96,97,112,113,114,128,129,130,131,143,144,145,146,147,148,149,150,151,153,154,155,156,157,158,159,160,161,162,163,164,165,166,167,169,170,171,172,173,174,175,176













1,2,3,4,5,6,7,10,11,12,13,14,15,16,17,18,19,20,21,22,23,26,27,29,30,31,32,33,34,35,46,47,48,49,50,63,64,70,75,102,107,113,114,127,128,129,130,131,142,143,144,145,146,147,148,149,150,151,152,153,154,155,156,157,158,159,160,161,162,163,164,165,166,167,168,169,170,171,172,173,174,175,176

1,2,3,4,5,6,7,9,10,11,12,13,14,15,16,17,18,19,20,21,22,23,25,26,27,28,29,30,31,32,33,34,39,41,42,43,46,47,48,49,50,55,57,58,59,62,63,64,65,71,73,74,75,78,79,80,81,97,110,111,112,113,114,126,127,128,129,130,142,143,144,145,146,147,148,149,150,151,152,153,154,155,156,157,158,159,160,161,162,163,164,165,166,167,168,169,170,171,172,173,174,175,176







111,112,127,128,143,144,159,160,175,176
97,98,111,112,113,114,127,128,129,130,143,144,145,146,155,157,159,160,161,162,171,173,175,176
97,98,99,113,114,115,129,130,131,145,146,147,161,162,163







1,2,3,4,5,6,7,8,9,10,11,12,13,14,15,16,17,18,19,20,21,22,23,25,26,27,28,29,30,31,32,33,34,41,42,43,44,47,48,49,58,59,64,69,77,80,96,101,109,112,113,122,123,128,129,130,137,138,139,140,143,144,145,146,147,148,149,150,151,152,153,154,155,156,157,158,159,160,161,162,163,164,165,166,167,168,169,170,171,172,173,174,175,176





1,2,3,6,7,8,9,12,13,15,16,17,18,19,22,23,25,28,29,31,32,33,34,35,49,50,113,114,129,130,131,145,146,147,148,149,150,151,152,153,154,155,156,157,158,159,160,161,162,163,164,165,166,167,168,169,170,171,172,173,174,175,176
1,2,11,13,15,16,17,18,27,29,31,32,145,146,147,148,152,153,154,155,156,157,158,159,160,161,162,163,164,168,169,170,171,172,173,174,175,176
1,2,3,4,5,6,7,8,9,10,11,12,13,14,15,16,17,18,19,20,21,22,23,25,26,27,28,29,30,31,32,47,48,52,53,54,55,64,73,74,75,84,85,86,87,105,106,107,116,117,118,119,128,143,144,145,146,147,148,149,150,151,152,153,154,155,156,159,160,161,162,163,164,165,166,167,168,169,170,171,172,175,176
1,2,3,4,5,6,7,8,9,10,11,12,13,14,15,16,17,18,19,20,21,22,23,25,26,27,28,29,30,31,32,33,34,42,43,47,48,49,52,54,61,64,84,86,93,113,116,118,125,128,129,130,138,139,143,144,145,146,147,148,149,150,151,154,155,156,157,158,159,160,161,162,163,164,165,166,167,170,171,172,173,174,175,176
1,2,17,18,33,34,49,113,129,130,145,146,161,162











1,2,3,4,5,6,7,8,9,10,11,12,13,14,15,16,17,18,19,20,21,22,23,24,25,26,27,28,29,30,31,32,33,34,47,48,49,64,80,96,112,113,128,129,130,143,144,145,146,147,148,149,150,151,152,153,154,155,156,157,158,159,160,161,162,163,164,165,166,167,168,169,170,171,172,173,174,175,176
1,2,3,4,8,9,10,11,12,13,14,15,16,17,18,20,24,25,26,27,28,29,30,31,32,33,34,49,57,61,65,75,81,84,89,93,97,107,113,121,125,129,130,145,146,147,148,149,152,153,154,155,156,157,158,159,160,161,162,163,164,165,168,169,170,171,172,173,174,175,176
1,2,3,4,5,6,7,8,9,10,11,12,15,16,17,18,19,20,21,22,24,25,26,27,31,32,47,48,57,63,64,75,80,83,86,89,107,112,121,127,128,143,144,145,146,147,148,149,150,151,152,153,154,155,156,157,158,159,160,161,162,163,164,165,166,167,168,169,170,171,172,173,174,175,176
1,2,3,4,5,6,7,10,11,12,13,14,15,16,17,18,19,20,22,26,27,28,29,30,31,32,33,34,35,42,43,44,45,46,47,48,49,50,58,59,60,61,62,63,64,65,75,76,77,78,79,80,113,114,127,128,129,130,143,144,145,146,159,160,161,162,163,164,165,166,167,168,169,170,171,172,173,174,175,176
1,2,17,18,33,34,49,50,65,97,113,114,129,130,145,146,161,162







