









52,53,54,55,56,57,58,59,60,68,69,70,71,72,73,74,75,76,84,85,86,87,88,89,90,91,92,100,101,102,103,104,105,106,107,108,119,135,151,167



1,2,3,4,5,6,7,8,9,10,11,12,13,14,15,16,17,18,19,20,21,22,23,24,25,26,27,28,29,30,31,32,33,34,35,36,37,38,39,40,41,42,43,44,45,46,47,48,59,60,61,62,63,64,75,76,77,78,79,80,91,92,93,94,95,96,107,108,109,110,111,112,123,124,125,126,127,128,139,140,141,142,143,144,155,156,157,158,159,160,171,172,173,174,175,176
1,16,17,32,33,48,49,64,65,80,81,96,97,112,113,128,129,144,145,160,161,176







71,72,73,74,75,76,77,78,79,80,87,103,119,135,151,167
65,66,67,68,69,70,71,72,73,74,75,76,77,78,79,80
65,66,67,68,69,70,71,72,73,74,75,76,77,78,79,80
7,23,39,55,65,66,67,68,69,70,71


106,107,108,109,110,111,112,122,123,124,125,126,127,128,138,139,140,141,142,143,144,154,155,156,157,158,159,160,170,171,172,173,174,175,176
97,98,99,100,101,102,103,113,114,115,116,117,118,119,129,130,131,132,133,134,135,145,146,147,148,149,150,151,161,162,163,164,165,166,167
16,32,48,64,80,96,112,128,144,160,176






106,107,108,109,110,111,112,122,123,124,125,126,127,128,138,139,140,141,142,143,144,154,155,156,157,158,159,160,170,171,172,173,174,175,176
7,23,39,55,71,87,97,98,99,100,101,102,103,104,105,106,107,108,109,110,111,112,113,114,115,116,117,118,119,120,121,122,123,124,125,126,127,128,129,130,131,132,133,134,135,136,137,138,139,140,141,142,143,144,145,146,147,148,149,150,151,152,153,154,155,156,157,158,159,160,161,162,163,164,165,166,167,168,169,170,171,172,173,174,175,176
97,98,99,100,101,102,103,113,114,115,116,117,118,119,119,129,130,131,132,133,134,135,135,145,146,147,148,149,150,151,161,162,163,164,165,166,167




10,11,12,13,14,15,16,26,27,28,29,30,31,32,42,43,44,45,46,47,48,58,59,60,61,62,63,64,74,75,76,77,78,79,80
1,2,3,4,5,6,7,8,9,10,11,12,13,14,15,16,17,18,19,20,21,22,23,24,25,26,27,28,29,30,31,32,33,34,35,36,37,38,39,40,41,42,43,44,45,46,47,48,49,50,51,52,53,54,55,56,57,58,59,60,61,62,63,64,65,66,67,68,69,70,71,72,73,74,75,76,77,78,79,80,90,91,92,93,94,95,96,106,107,108,109,110,111,112,122,123,124,125,126,127,128,138,139,140,141,142,143,144,154,155,156,157,158,159,160,170,171,172,173,174,174,175,176





106,107,108,109,110,111,112,122,123,124,125,126,127,128,138,139,140,141,142,143,144,154,155,156,157,158,159,160,170,171,172,173,174,175,176
97,98,99,100,101,102,103,104,105,106,107,108,109,110,111,112,113,114,115,116,117,118,119,120,121,122,123,124,125,126,127,128,129,130,131,132,133,134,135,136,137,138,139,140,141,142,143,144,145,146,147,148,149,150,151,152,153,154,155,156,157,158,159,160,161,162,163,164,165,166,167,168,169,170,171,172,173,174,175,176
10,11,12,13,14,15,16,26,27,28,29,30,31,32,42,43,44,45,46,47,48,58,59,60,60,61,62,63,64,74,75,76,77,78,79,80,90,91,92,93,94,95,96,97,98,99,100,101,102,103,104,105,106,107,108,109,110,111,112,112,113,114,115,116,117,118,119,120,121,122,123,124,125,126,127,128,129,130,131,132,133,134,135,136,137,138,139,140,141,142,143,144,145,146,147,148,149,150,151,152,153,154,155,156,157,158,159,160,161,162,163,164,165,166,167,168,169,170,171,172,173,174,175,176
1,16,17,32,33,48,49,64,65,80,81,97,112,113,128,129,144,145,160,161,176
1,2,3,4,5,6,7,17,18,19,20,21,22,23,33,34,35,36,37,38,39,49,50,51,52,53,54,55,65,66,67,68,69,70,71,97,98,99,100,101,102,103,113,114,115,116,117,118,119,129,130,131,132,133,134,135,145,146,147,148,149,150,151,161,162,163,164,165,166,167
54,55,56,57,58,59,70,71,72,73,74,75,86,87,88,89,90,91,102,103,104,105,106,107




10,11,12,13,13,14,15,16,26,27,28,29,30,31,32,42,43,44,45,46,47,48,58,59,60,61,62,63,64,74,75,76,77,78,79,80
1,2,3,4,5,6,7,8,9,10,11,12,13,14,15,16,17,18,19,20,21,22,23,24,25,26,27,28,29,30,31,32,33,34,35,36,37,38,39,40,41,42,43,44,45,46,47,48,49,50,51,52,53,54,55,56,57,58,59,60,61,62,63,64,65,66,67,68,69,70,72,73,74,75,76,77,78,79,80,90,91,92,93,94,95,96,106,107,108,109,110,111,112,122,122,123,124,125,126,126,127,128,138,139,140,140,141,142,143,144,154,155,156,157,158,159,160,170,171,172,173,174,175,176



54,55,56,57,58,59,70,71,72,73,74,75,86,87,88,89,90,91,102,103,104,105,106,107
10,11,12,13,14,15,16,26,27,28,29,30,31,32,42,43,44,44,45,46,47,48,58,59,60,61,62,63,64,74,75,76,77,78,79,80,90,91,92,93,94,95,96,106,107,108,109,110,111,112,122,123,124,125,126,127,128,138,139,140,141,142,143,144,154,155,156,157,158,159,160,170,171,172,173,174,175,176
1,16,17,32,33,48,49,64,65,80,81,96,97,112,113,128,129,144,145,160,161,176
1,2,3,4,5,6,7,8,9,10,11,12,13,14,15,16,17,18,19,20,21,22,23,24,25,26,27,28,29,30,31,32,33,34,35,36,37,38,39,40,41,42,43,44,44,45,46,47,48,49,50,51,52,53,54,55,56,57,58,59,60,61,62,63,64,65,66,67,68,69,70,71,72,73,74,75,76,77,78,79,80,81,82,83,84,85,86,87,97,98,99,100,101,102,103,113,114,115,116,117,118,119,129,130,131,132,133,134,135,145,146,147,148,149,150,151,161,162,163,164,165,166,167
1,2,3,3,4,5,6,7,8,9,10,11,12,13,14,15,16,17,18,19,20,21,22,23,24,25,26,27,28,29,30,31,32,33,34,35,36,37,38,39,40,41,42,43,44,45,46,47,48,49,50,51,52,53,54,55,56,57,58,59,60,61,62,63,64,65,66,67,68,69,70,71,72,73,74,75,76,77,78,79,80
1,2,3,4,5,6,7,17,18,19,20,21,22,23,33,34,35,36,37,38,39,49,50,51,52,53,54,55,65,66,67,68,69,70,71






10,11,12,13,14,15,16,26,27,28,29,30,31,32,42,43,44,45,46,47,48,58,59,60,61,62,63,64,74,75,76,77,78,79,80,90,92,95,96,106,107,108,109,110,110,111,112,122,123,124,125,126,127,128,128,138,139,140,141,142,143,144,154,155,156,157,158,159,160,170,171,172,173,174,175,176




10,11,12,13,14,15,16,26,27,28,29,30,31,32,42,43,44,45,46,47,48,58,59,60,61,62,63,63,64,74,75,76,77,78,79,80
1,2,3,4,5,6,7,8,8,9,10,11,12,13,14,15,16,17,18,19,20,21,22,23,24,25,26,26,27,28,29,30,31,32,33,34,35,36,37,38,39,40,41,42,43,44,45,46,47,48,49,50,51,52,53,54,55,56,57,58,59,60,61,62,63,64,65,66,67,68,69,70,71,72,74,75,76,77,78,79,80,86,87,102,103,118,119,134,135,150,151,166,167
1,2,3,4,5,5,6,7,17,18,19,20,21,22,23,33,34,35,36,37,38,39,49,50,51,52,53,54,55,65,66,67,68,69,70,71


106,107,108,109,110,111,112,122,123,124,125,126,127,128,138,139,140,141,142,143,144,154,155,156,157,158,159,160,170,171,172,173,174,175,176
97,98,99,100,101,102,103,113,114,115,116,117,118,119,129,130,131,132,133,134,135,145,146,147,148,149,150,151,161,162,163,164,165,166,167




10,11,12,13,14,15,16,26,27,28,29,30,31,31,32,42,43,44,45,46,47,48,58,59,60,61,62,63,64,74,75,76,77,78,79,80,90,92,94,95,96,106,107,108,109,110,111,112,122,123,124,125,126,127,128,138,138,139,140,141,142,143,144,154,155,156,157,158,159,160,170,171,172,173,174,175,176





6,7,22,23,38,39,54,55,70,71,102,103,118,119,134,135,150,151,166,167



10,11,12,13,14,15,16,26,27,28,29,30,31,32,42,43,44,45,46,47,48,58,59,60,61,62,63,64,74,75,76,77,78,79,80
1,2,2,3,4,5,6,7,17,18,19,20,21,22,23,33,34,35,36,37,38,39,49,50,51,52,53,54,55,65,66,67,68,69,70,71




10,11,12,13,14,15,16,26,27,28,29,30,31,32,42,43,44,45,46,47,48,58,59,60,61,62,63,64,74,75,76,77,78,79,80,90,91,92,93,94,95,96,106,107,108,109,110,111,112,122,123,124,125,126,127,128,138,139,140,141,142,143,144,154,155,156,157,158,159,160,170,171,172,173,174,175,176





6,7,22,23,38,39,54,55,70,71,86,87,102,103,118,119,134,135,150,151,166,167





104,105,106,107,108,109,110,110,111,112,120,121,122,123,124,125,126,127,128,136,137,138,139,140,141,142,143,144,152,153,154,155,156,157,157,158,159,160,168,169,170,171,172,173,174,175,176
97,98,99,100,101,102,103,104,105,106,107,108,109,110,111,112,113,114,115,116,117,118,119,120,121,122,123,124,125,126,127,128,129,130,131,132,133,134,135,136,137,138,139,140,141,141,142,143,144,145,146,147,148,149,150,151,152,153,154,155,156,157,158,159,160,161,162,163,164,165,166,167,168,169,170,171,172,173,174,175,176
97,98,99,100,101,102,103,104,105,106,107,108,109,110,111,112,113,114,115,116,117,118,119,120,121,122,123,124,125,126,127,128,129,130,131,132,133,134,135,136,137,138,139,140,141,142,143,144,145,146,147,148,149,150,151,152,153,154,155,156,157,158,159,160,161,162,163,164,165,166,167,168,169,170,171,172,173,174,175,176
97,98,99,100,101,102,103,104,105,106,107,108,109,110,111,111,112,113,114,115,116,117,118,119,120,121,122,123,124,125,126,127,128,129,129,130,131,132,133,134,135,136,137,138,139,140,141,141,142,143,144,145,146,147,148,149,150,151,152,153,154,155,156,157,158,159,160,161,162,163,164,165,166,167,168,169,170,171,172,173,174,175,176
10,11,12,13,14,15,16,26,27,28,29,30,31,32,42,43,44,45,46,47,48,58,59,60,61,62,63,64,74,75,76,77,78,79,80,90,91,92,93,94,95,96,97,98,99,100,101,102,103,104,105,106,107,108,109,110,111,112,113,114,115,116,117,118,119,120,121,122,123,124,125,126,127,128,129,130,131,132,133,134,135,136,137,138,139,140,141,142,143,144,145,146,147,148,149,150,151,152,153,154,155,156,157,158,159,160,161,162,163,164,165,166,167,168,169,170,170,171,171,172,172,173,173,174,174,175,175,176,176
